/data/tags/birds.json	/data/tags/bird.json;
/data/tags/ponte.json	/data/tags/bridge.json;
/data/tags/ponte-luis.json	/data/tags/bridge.json;
/data/tags/cafe-central.json	/data/tags/cafe.json;
/data/tags/castelo.json	/data/tags/castle.json;
/data/tags/castelo-obidos.json	/data/tags/castle.json;
/data/tags/se.json	/data/tags/cathedral.json;
/data/tags/se-velha.json	/data/tags/cathedral.json;
/data/tags/ceramica.json	/data/tags/ceramic.json;
/data/tags/funiculaires.json	/data/tags/funiculaire.json;
/data/tags/funikuler.json	/data/tags/funiculaire.json;
/data/tags/lago.json	/data/tags/lake.json;
/data/tags/lagoa.json	/data/tags/lake.json;
/data/tags/highlake.json	/data/tags/lake.json;
/data/tags/metro2.json	/data/tags/metro.json;
/data/tags/foldalatti.json	/data/tags/metro.json;
/data/tags/museu.json	/data/tags/museum.json;
/data/tags/ocean-museum.json	/data/tags/museum.json;
/data/tags/noite.json	/data/tags/night.json;
/data/tags/parque.json	/data/tags/park.json;
/data/tags/praia-vermelha.json	/data/tags/plage.json;
/data/tags/praia.json	/data/tags/plage.json;
/data/tags/playa.json	/data/tags/plage.json;
/data/tags/rent-a-car.json	/data/tags/rentacar.json;
/data/tags/santos-2.json	/data/tags/santos.json;
/data/tags/zubchatka.json	/data/tags/trem-do-corcovado.json;
/data/tags/universidade.json	/data/tags/university.json;
/data/tags/puc.json	/data/tags/university.json;
/data/tags/ufmg.json	/data/tags/university.json;
/data/tags/hauptbahnhof.json	/data/tags/vauxhall.json;
/data/tags/sao-bento.json	/data/tags/vauxhall.json;
